111111111111
1P00C00E01C1
100000C00111
111111111111