111111111111
1PE0C0000001
111110111101
100000000001
111111111111