111111111111
1P00C00E01C1
10000PC00111
111111111111