1111111111
1P00C00E01
100P00C001
1111111111