11111111111111
10000000000001
100000001E1011
10100000001011
101000000C0001
101100000C0001
100000000P0001
11111111111111