11111111111111111
11C000000000E0001
11110000111011111
10100000001000011
111000000C0001001
1P110001100001111
10000001C00000001
11111111111111111