111111111111111111111111
111111111111111111111111
11C000111111111011111011
110X00111111C00000000011
111110111111101110111011
11C0000000000000000C0011
111111111110111111011111
110100000010000000010011
110111101011101111011111
11C1E0000010000000000011
110110111011101110111011
1100000000000000000C0011
111111111110111111011111
1110C0000000000000000011
111111101110111111011111
110000000010000000000011
111110111011101110111P11
111111111111111111111111
111111111111111111111111