11111111111111
10000000000X01
10x000001E1011
10000000001011
100000000C0001
100000000C0001
100X00000P0001
11111111111111