111111111111
1P00C00E01C1
100000C00001
111111111111