1111111111111111111
1C000000000C0000001
1011111110111111101
100000000X000000001
1011011111111110111
1CE10000010000000C1
1111111111101111111
1000000000100000001
1011111111111111101
1000000000000000001
1C010001011111110C1
1011010110000001101
1000010100100000001
1111110101101111111
1000000000100000001
1011110111111011101
1000000000100000001
1011P11111111011101
1C000000000000000C1
1111111111111111111