11111111111111
11111111111111
1C0000000E1011
10000111111011
100010000C0001
100011111C0001
100000000P0001
11111111111111