1111111111111111111111111111111111111
11111111P1011011111111111111111111111
1000000001000000000010000000100000001
1000001111111111100010100X10101011001
110100000010001000101C100110101001001
1101110110100011101011111100101001101
1101010110100010101000000000101000001
1101010000101110101111000111101111101
1101011000000000100000000000000010101
1100000011111011101110111110111000101
1100100010000000001000001000001010101
1111111010111010001110001011101010111
1100X01010010010000010E010000010000C1
1101101111111110111011111011101110101
11111000000000001C1001000010000000101
11000C1111001011101111111110111010101
11001110000010000000000X1010000010001
1111111111111111111111111111111111111