11111111111111
10000000000X01
100000001E1011
10000000001011
100000000C0001
100000000C0001
100000000P0001
11111111111111