111111111111111111111
100C00000000000000001
100000000000000000001
1001100110001111100C1
100110011000000011001
10011P011000000011001
100111111000011110001
100011111000110000001
1C000001100011E000001
100000011000111111001
100000000000000000001
100000C00000000000001
111111111111111111111