111111111111111111
11C000000000E00011
110100001111111111
100100000010001001
100100000C01111001
1P1111100001000001
10000010C001111111
111111111111111111