1111111111111111111
1P00000001000000001
1C110111010111011C1
100000000000000X001
1011010111110101101
1000010001000100001
1111011101011101111
1001010000X00101001
1111010110110101111
100000010E010000001
1111010111110101111
1001010000000101001
1111010111110101111
1000000001000000001
10110111010111011X1
1C010000000000010C1
1101010111110101011
1X00010001000100001
1011111101011111101
1000000000000000001
1111111111111111111