11111111111111
10000000000001
10000000111011
100000000E1011
100000000C0001
10000000000001
100000000P0001
11111111111111