11111111111111
10000C00000001
10P00000000001
100000000E0001
11111111111111