11111111111111
10000C00000001
10P00000111011
100000000E1C11
11111111111111